W	west
WA	west@n@`str\{Ilj@
Wednesday	`wenzd{I
w	`d6b@lj}:
wad	wOd
waddle	`wOd@l
wade	w{Id
wafer	`w{If@
wag	w{g
wage	w{IdZ
wager	`w{IdZ@
wail	w{Il
waist	w{Ist
wait	w{It
waiter	`w{It@
wake	w{Ik
walk	wo:k
walkover	`wo:k@}v@
wall	wo:l
wallet	`wOl@t
wallpaper	`wo:lp{Ip@
waltz	wo:lts
wander	`wOnd@
wane	w{In
wangle	`w{Ng@l
wank	w{nk
want	wOnt
war	wo:
ward	wo:d
warden	`wo:d@n
warder	`wo:d@
wardrobe	`wo:dr\@}b
warehouse	`we:h{Os
warfare	`wo:fe:
warm	wo:m
warn	wo:n
warning	`wo:nIN
warp	wo:p
warped	wo:pt
warrant	`wOr\@nt
warranty	`wOr\@nti:
wart	wo:t
wary	`we:r\i:
was	wOz
wash	wOS
washed-out	`wOSt{Ot
washer	`wOS@
waste	w{Ist
wastepaper basket	w{Ist`p{Ip@b6:sk@t
watch	wOtS
water	`wo:t@
watercolour	`wo:t@k6l@
waterfront	`wo:t@fr\6nt
waterlogged	`wo:t@lOgd
waterproof	`wo:t@pr\}:f
waterski	`wo:t@ski:
watertight	`wo:t@tAet
watt	wOt
wattle	`wOt@l
wave	w{Iv
wax	w{ks
way	w{I
way-out	`w{I{Ot
we	wi:
weak	wi:k
wealth	welT
wealthy	`welTi:
weapon	`wep@n
wear	we:
weary	`wI@r\i:
weather	`weD@
weave	wi:v
web	web
webbed	webd
wedding	`wedIN
wedge	wedZ
weed	wi:d
week	wi:k
weekday	`wi:kd{I
weekend	wi:k`end
weekly	`wi:kli:
weep	wi:p
weigh	w{I
weight	w{It
weird	wI@d
welcome	`welk@m
weld	weld
welfare	`welfe:
well	wel
well-off	wel`Of
wellbeing	`welbi:IN
went	went
wept	wept
were	w3:
werent	w3:nt
west	west
western	`west@n
wet	wet
whack	w{k
wharf	wo:f
what	wOt
whatever	wOt`ev@
whatsoever	wOts@}`ev@
wheat	wi:t
wheel	wi:l
wheelbarrow	`wi:lb{r\@}
wheelchair	`wi:ltSe:
when	wen
whenever	wen`ev@
where	we:
whereabouts	`we:r\@b{Ots
whereas	we:r\`{z
wherever	we:r\`ev@
whether	`weD@
which	wItS
whiff	wIf
while	wAel
whim	wIm
whimper	`wImp@
whine	wAen
whinge	wIndZ
whip	wIp
whirl	w3:l
whirlwind	`w3:lwInd
whirr	w3:
whisk	wIsk
whisker	`wIsk@
whisky	`wIski:
whisper	`wIsp@
whistle	`wIs@l
white	wAet
white ant	`wAet{nt
white-ant	`wAet{nt
white-out	`wAet{Ot
whitewash	`wAetwOS
whiz	wIz
who	h}:
whoever	h}:`ev@
whole	h@}l
wholemeal	`h@}lmi:l
wholesale	`h@}ls{Il
wholesome	`h@}ls@m
whom	h}:m
whopping	`wOpIN
whore	ho:
whose	h}:z
why	wAe
wick	wIk
wicked	`wIk@d
wicket	`wIk@t
wide	wAed
widespread	`wAedspr\ed
widow	`wId@}
widower	`wId@}@
wife	wAef
wig	wIg
wiggle	`wIg@l
wild	wAeld
wild flower	`wAeldfl{O@
wilderness	`wIld@nes
wildlife	`wAeldlAef
wilful	`wIlfUl
will	wIl
willing	`wIlIN
willpower	`wIlp{O@
wilt	wIlt
wily	`wAeli:
wimp	wImp
win	wIn
wince	wIns
wind	wInd
window	`wInd@}
window shopping	`wInd@}SOpIN
windowsill	`wInd@}sIl
windpipe	`wIndpAep
windscreen	`wIndskr\i:n
windsurf	`wInds3:f
windy	`wIndi:
wine	wAen
wing	wIN
wink	wINk
winning	`wInIN
winter	`wInt@
wipe	wAep
wire	`wAe@
wiry	`wAe@r\i:
wisdom tooth	`wIzd@mt}:T
wise	wAez
wish	wIS
wishy-washy	`wISi:wOSi:
wit	wIt
witch	wItS
with	wIT
withdraw	wID`dr\o:
withhold	wID`h@}ld
within	wID`In
without	wID`{Ot
witness	`wItn@s
wizard	`wIz@d
wobble	`wOb@l
woe	w@}
woeful	`w@}fUl
wog	wOg
wok	wOk
woke	w@}k
wolf	wUlf
woman	`wUm@n
womb	w}:m
wombat	`wOmb{t
won	w6n
wonder	`w6nd@
wonderful	`w6nd@fUl
wood	wUd
woodwork	`wUdw3:k
wool	wUl
word	w3:d
word processor	`w3:dpr\@}ses@
wore	wo:
work	w3:k
workbench	`w3:kbentS
workforce	`w3:kfo:s
workload	`w3:kl@}d
workout	`w3:k{Ot
workplace	`w3:kpl{Is
workshop	`w3:kSOp
world	w3:ld
worldwide	w3:ld`wAed
worm	w3:m
worn	wo:n
worn-out	wo:n`{Ot
worry	`w6r\i:
worse	w3:s
worship	`w3:SIp
worst	w3:st
worth	w3:T
worthwhile	w3:T`wAel
worthy	`w3:Di:
would	wUd
wound	w{Ond
woven	`w@}v@n
wow	w{O
wowser	`w{Oz@
wrap	r\{p
wreath	r\i:T
wreck	r\ek
wrestle	`r\es@l
wretch	r\etS
wriggle	`r\Ig@l
wring	r\IN
wrinkle	`r\INk@l
wrist	r\Ist
write	r\Aet
write-off	`r\AetOf
wrong	r\ON
wrote	r\@}t
wrung	r\6N
wuss	wUs
