E	i:
EB	i:`bi:
ECG	i:si:`dZi:
EFTPOS	`eftpOs
ESL	i:es`el
Easter	`i:st@
English	`INglIS
e	i:
e-mail	`i:m{Il
e.g.	i:`dZi:
each	i:tS
eager	`i:g@
ear	I@
eardrum	`I@dr\6m
early	`3:li:
earn	3:n
earnest	`3:n@st
earphone	`I@f@}n
earring	`I@r\IN
earth	3:T
earthenware	`3:D@nwe:
earthquake	`3:Tkw{Ik
ease	i:z
easel	`i:z@l
east	i:st
eastward	`i:stw@d
easy	`i:zi:
eat	i:t
eaves	i:vz
eavesdrop	`i:vzdr\Op
ebb	eb
eccentric	ek`sentr\Ik
echidna	@`kIdn@
echo	`ek@}
eclipse	@`klIps
ecology	@`kOl@dZi:
economics	ek@`nOmIks
economy	@`kOn@mi:
eczema	`eks@m@
edge	edZ
edible	`ed@b@l
edit	`ed@t
edition	@`dIS@n
editorial	ed@`to:r\i:@l
education	edZ@`k{IS@n
eerie	`I@r\i:
effect	@`fekt
effective	@`fektIv
effeminate	@`fem@n@t
effervescent	ef@`ves@nt
efficient	@`fIS@nt
effort	`ef@t
egg	eg
ego	`i:g@}
eiderdown	`Aed@d{On
eight	{It
eighteen	{I`ti:n
eighteenth	{I`ti:nT
eighth	{ItT
eighty	`{Iti:
either	`AeD@
eject	@`dZekt
elaborate	@`l{b@r\@t
elapse	@`l{ps
elastic	@`l{stIk
elated	@`l{It@d
elbow	`elb@}
elder	`eld@
elderly	`eld@li:
eldest	`eld@st
elect	@`lekt
election	@`lekS@n
elective	@`lektIv
electorate	@`lekt@r\@t
electrician	@lek`tr\IS@n
electricity	@lek`tr\Is@ti:
electrocute	@`lektr\@kj}:t
electronic	el@k`tr\OnIk
elegant	`el@g@nt
element	`el@m@nt
elementary	el@`mentr\i:
elevate	`el@v{It
elevator	`el@v{It@
eleven	@`lev@n
eleventh	@`lev@nT
eligible	`el@dZ@b@l
eliminate	@`lIm@n{It
elite	@`li:t
ellipse	@`lIps
eloquent	`el@kw@nt
else	els
elsewhere	`elswe:
elusive	@`l}:sIv
embargo	em`b6:g@}
embark	em`b6:k
embarrass	em`b{r\@s
embassy	`emb@si:
embezzle	em`bez@l
emblem	`embl@m
embrace	em`br\{Is
embroider	em`br\oId@
embryo	`embr\i:@}
emerald	`emr\@ld
emerge	@`m3:dZ
emergency	@`m3:dZ@nsi:
emigrant	`em@gr\@nt
emigrate	`em@gr\{It
eminent	`em@n@nt
emotion	@`m@}S@n
emphasis	`emf@s@s
empire	`empAe@
employ	em`ploI
empty	`empti:
emu	`i:mj}:
enable	en`{Ib@l
enamel	@`n{m@l
enclose	en`kl@}z
encode	en`k@}d
encore	`ONko:
encounter	en`k{Ont@
encourage	en`k6r\IdZ
encyclopedia	ensAekl@`pi:di:@
end	end
endanger	en`d{IndZ@
endeavour	en`dev@
endorse	en`do:s
endure	en`djU@
enemy	`en@mi:
energy	`en@dZi:
engage	en`g{IdZ
engagement	en`g{IdZm@nt
engine	`endZ@n
engineer	endZ@`nI@
engrave	en`gr\{Iv
enjoy	en`dZoI
enlarge	en`l6:dZ
enlist	en`lIst
enormous	@`no:m@s
enough	@`n6f
enquiry	In`kwAer\i:
enrage	en`r\{IdZ
enrich	en`r\ItS
enrol	en`r\@}l
ensuite	`Onswi:t
ensure	en`So:
entangled	en`t{Ng@ld
enter	`ent@
enterprise	`ent@pr\Aez
enterprise bargaining	ent@pr\Aez`b6:g@nIN
entertain	ent@`t{In
enthusiasm	en`T}:zi:{z@m
entice	en`tAes
entire	en`tAe@
entitle	en`tAet@l
entrance	`entr\@ns
entrant	`entr\@nt
entreat	en`tr\i:t
entree	`Ontr\{I
entrepreneur	Ontr\@pr\@`n3:
entry	`entr\i:
envelope	`env@l@}p
environment	en`vAer\@nm@nt
envy	`envi:
epic	`epIk
epidemic	ep@`demIk
epilepsy	`ep@lepsi:
episode	`ep@s@}d
epitome	@`pIt@mi:
epoch	`i:pOk
equal	`i:kw@l
equator	@`kw{It@
equip	@`kwIp
equipment	@`kwIpm@nt
equivalent	@`kwIv@l@nt
era	`I@r\@
eradicate	@`r\{d@k{It
erase	@`r\{Iz
erect	@`r\ekt
erode	@`r\@}d
erotic	@`r\OtIk
err	3:
errand	`er\@nd
erratic	@`r\{tIk
error	`er\@
erupt	@`r\6pt
escalate	`esk@l{It
escalator	`esk@l{It@
escapade	`esk@p{Id
escape	@`sk{Ip
escort	@s`ko:t
esky	`eski:
especially	@`speS@li:
espionage	`espi:@n6:Z
essay	`es{I
essence	`es@ns
essential	@`senS@l
establish	@`st{blIS
establishment	@`st{blISm@nt
estate	@`st{It
estate agent	@`st{It{IdZ@nt
esteem	@`sti:m
estimate	`est@m{It
estranged	@`str\{IndZd
etc.	et`setr\@
etch	etS
etching	`etSIN
eternal	@`t3:n@l
ethics	`eTIks
ethnic	`eTnIk
etiquette	`eti:k@t
eucalyptus	j}:k@`lIpt@s
euthanasia	j}:T@`n{IZ@
evacuate	@`v{kj}:{It
evade	@`v{Id
evaluate	@`v{lj}:{It
evaporate	@`v{p@r\{It
eve	i:v
even	`i:v@n
evening	`i:vnIN
evening class	`i:vnINkl6:s
evening dress	`i:vnINdr\es
event	@`vent
eventually	@`ventS@li:
ever	`ev@
evergreen	`ev@gr\i:n
every	`evr\i:
everybody	`evr\i:bOdi:
everyday	`evr\i:d{I
everyone	`evr\i:w6n
everything	`evr\i:TIN
everywhere	`evr\i:we:
evict	@`vIkt
evidence	`ev@d@ns
evident	`ev@d@nt
evil	`i:v@l
evolution	ev@`l}:S@n
ex-	eks
exact	@g`z{kt
exactly	@g`z{ktli:
exaggerate	@g`z{dZ@r\{It
exam	@g`z{m
examination	@gz{m@`n{IS@n
examine	@g`z{m@n
example	@g`z{mp@l
exasperate	@g`z{sp@r\{It
excavate	`eksk@v{It
exceed	@k`si:d
excel	@k`sel
excellent	`eks@l@nt
except	@k`sept
exception	@k`sepS@n
exceptional	@k`sepS@n@l
excess	`ekses
exchange	@ks`tS{IndZ
excite	@k`sAet
excited	@k`sAet@d
exciting	@k`sAetIN
exclaim	@k`skl{Im
exclamation	ekskl@`m{IS@n
exclude	@k`skl}:d
exclusive	@k`skl}:sIv
excrete	@k`skr\i:t
excruciating	@k`skr\}:Si:{ItIN
excursion	@k`sk3:S@n
excuse	@k`skj}:s
execute	`eks@kj}:t
executive	@g`zekj@tIv
executor	@g`zekj@t@
exempt	@g`zempt
exercise	`eks@sAez
exert	@g`z3:t
exhale	eks`h{Il
exhaust	@g`zo:st
exhaustive	@g`zo:stIv
exhibit	@g`zIb@t
exile	`egzAel
exist	@g`zIst
exit	`eks@t
exodus	`eks@d@s
exotic	@g`zOtIk
expand	@k`sp{nd
expanse	@k`sp{ns
expect	@k`spekt
expedition	eksp@`dIS@n
expel	@k`spel
expend	@k`spend
expenditure	ek`spend@tS@
expense	@k`spens
expensive	@k`spensIv
experience	@k`spI@r\i:ens
experiment	@k`sper\@m@nt
expert	`eksp3:t
expire	@k`spAe@
explain	@k`spl{In
expletive	@k`spli:tIv
explode	@k`spl@}d
exploit	@k`sploIt
explore	@k`splo:
explosion	@k`spl@}Z@n
explosive	ek`spl@}sIv
export	ek`spo:t
expose	@k`sp@}z
exposure	@k`sp@}Z@
express	@k`spr\es
expression	@k`spr\eS@n
expressway	ek`spr\esw{I
expulsion	@k`sp6lS@n
exquisite	ek`skwIz@t
extend	@k`stend
extension	@k`stenS@n
extensive	@k`stensIv
extent	@k`stent
exterior	@k`stI@r\i:@
exterminate	@k`st3:m@n{It
external	@k`st3:n@l
extinct	@k`stINkt
extinguish	@k`stINgwIS
extortion	@k`sto:S@n
extra	`ekstr\@
extract	@k`str\{kt
extraordinary	@k`str\o:d@nr\i:
extravagant	@k`str\{v@g@nt
extreme	@k`str\i:m
extremism	@k`str\i:mIz@m
eye	Ae
eyebrow	`Aebr\{O
eyelash	`Ael{S
eyelid	`AelId
eyesight	`AesAet
eyesore	`Aeso:
eyewitness	`AewItn@s
