K	k{I
KO	k{I`@}
Khmer	k@`me:
Korean	k@`r\i:@n
k	k{I
kJ	`kIl@dZ}:l
kaleidoscope	k@`lAed@sk@}p
kangaroo	k{Ng@`r\}:
karate	k@`r\6:ti:
kayak	`kAe{k
kebab	k@`b{b
keel	ki:l
keen	ki:n
keep	ki:p
keeper	`ki:p@
keeping	`ki:pIN
keepsake	`ki:ps{Ik
keg	keg
kelp	kelp
kennel	`ken@l
kept	kept
kerb	k3:b
kernel	`k3:n@l
kero	`ker\@}
kerosene	ker\@`si:n
ketchup	`ketS@p
kettle	`ket@l
key	ki:
keyboard	`ki:bo:d
keynote	`ki:n@}t
kg	k{I`dZi:
khaki	k6:`ki:
kibble	`kIb@l
kick	kIk
kid	kId
kidnap	`kIdn{p
kidney	`kIdni:
kill	kIl
killing	`kIlIN
kiln	kIln
kilo	`ki:l@}
kilobyte	`kIl@bAet
kilogram	`kIl@gr\{m
kilohertz	`kIl@h3:ts
kilojoule	`kIl@dZ}:l
kilometre	k@`lOm@t@
kilowatt	`kIl@wOt
kilt	kIlt
kimono	`kIm@n@}
kin	kIn
kind	kAend
kindergarten	`kInd@g6:t@n
kindle	`kInd@l
kindling	`kIndlIN
kindly	`kAendli:
kindred	`kIndr\@d
kindy	`kIndi:
king	kIN
kingdom	`kINd@m
kink	kINk
kinship	`kInSIp
kiosk	`ki:Osk
kiss	kIs
kit	kIt
kitchen	`kItS@n
kitchen tea	kItS@n`ti:
kitchenette	kItS@`net
kite	kAet
kitsch	kItS
kitten	`kIt@n
kiwi	`ki:wi:
kleptomania	klept@`m{Ini:@
km	k@`lOm@t@
knack	n{k
knackered	`n{k@d
knapsack	`n{ps{k
knave	n{Iv
knead	ni:d
knee	ni:
kneecap	`ni:k{p
kneel	ni:l
knew	nj}:
knick-knack	`nIkn{k
knickers	`nIk@z
knife	nAef
knight	nAet
knit	nIt
knitting	`nItIN
knob	nOb
knock	nOk
knot	nOt
know	n@}
knowing	`n@}IN
knowledge	`nOlIdZ
known	n@}n
knuckle	`n6k@l
koala	k@}`6:l@
kookaburra	`kUk@b6r\@
kosher	`k@}S@
kung-fu	k6N`f}:
