Y	wAe
y	wAe
yacht	jOt
yak	j{k
yakka	`j{k@
yank	j{Nk
yap	j{p
yard	j6:d
yarn	j6:n
yawn	jo:n
yd	j6:d
yeah	je:
year	jI@
yeast	ji:st
yell	jel
yellow	`jel@}
yelp	jelp
yen	jen
yes	jes
yesterday	`jest@d{I
yet	jet
yield	ji:ld
yoga	`j@}g@
yoghurt	`j@}g@t
yolk	j@}k
yonks	jONks
you	j}:
young	j6N
youngster	`j6Nst@
your	jo:
yours	jo:z
yourself	jo:`self
youth	j}:T
yr	jI@
yuk	j6k
yuppie	`j6pi:
